111111111111111111111111
10000001000000000C000001
10C000010000000000000001
100000010000000000000001
1000P0010001111111111111
1000000000000000000C0001
111111100000000000000001
100000000000000000000001
1011111111110000C0000001
10C000000000100000000001
100000000000101111111111
100000000000100000000001
100000000000100000000001
100000000C00100000000001
100000000000100000000001
100000000000100000C00001
10E000000000100000000001
100000000000100000000001
111111111111111111111111
